11111111111111111111111111111111111111111111
1P000000000100000000C000001000000000E0000001
10010010100100000101001000000010000000000001
100100101101111100010010000000111010000C0001
1000000000C00C0100000000000000001C0000000001
10010000000011111000001111100000100000000001
1001011111100000001111000000000C100001000001
10000000001001000000000010000000101000000001
1000C00000100000000C000010000000001000000001
11111111111111111111111111111111111111111111
